Title,Budget,Revenue,Profit,Diff,Target
The Shawshank Redemption,25000000,28341469,3341469,0.13365876,0
The Godfather,6000000,245066411,239066411,39.844401833333336,1
The Dark Knight,185000000,1004558444,819558444,4.430045643243243,1
The Godfather: Part II,13000000,47542841,34542841,2.6571416153846155,1
12 Angry Men,350000,1000000,650000,1.8571428571428568,1
The Lord of the Rings: The Return of the King,94000000,1118888979,1024888979,10.903074244680852,1
Pulp Fiction,8000000,213928762,205928762,25.74109525,1
Schindler's List,22000000,321365567,299365567,13.607525772727271,1
Inception,160000000,825532764,665532764,4.159579775,1
Fight Club,63000000,100853753,37853753,0.6008532222222223,0
The Lord of the Rings: The Fellowship of the Ring,93000000,871368364,778368364,8.369552301075268,1
Forrest Gump,55000000,677945399,622945399,11.326279981818182,1
"Il buono, il brutto, il cattivo",1200000,6000000,4800000,4.0,1
The Lord of the Rings: The Two Towers,79000000,926287400,847287400,10.725156962025316,1
The Matrix,63000000,463517383,400517383,6.357418777777778,1
One Flew Over the Cuckoo's Nest,3000000,108981275,105981275,35.32709166666667,1
Hamilton,0,0,0,0.0,0
Interstellar,165000000,675120017,510120017,3.0916364666666665,1
Cidade de Deus,3300000,30641770,27341770,8.28538484848485,1
Saving Private Ryan,70000000,481840909,411840909,5.8834415571428575,1
The Green Mile,60000000,284600000,224600000,3.743333333333333,1
La vita � bella,20000000,229400000,209400000,10.47,1
Se7en,33000000,327311859,294311859,8.918541181818181,1
The Silence of the Lambs,19000000,272742922,253742922,13.354890631578948,1
Star Wars,11000000,775398007,764398007,69.49072790909091,1
It's a Wonderful Life,3180000,9644124,6464124,2.032743396226415,1
Joker,0,0,0,0.0,0
Whiplash,3300000,13092000,9792000,2.9672727272727277,1
The Prestige,40000000,109676311,69676311,1.741907775,1
The Departed,90000000,289847354,199847354,2.2205261555555555,1
The Pianist,35000000,120072577,85072577,2.4306450571428573,1
Gladiator,103000000,457640427,354640427,3.4431109417475727,1
American History X,20000000,23875127,3875127,0.19375635,0
The Usual Suspects,6000000,23341568,17341568,2.890261333333333,1
L�on,16000000,45284974,29284974,1.830310875,1
The Lion King,45000000,788241776,743241776,16.516483911111113,1
Terminator 2: Judgment Day,100000000,520000000,420000000,4.2,1
Nuovo Cinema Paradiso,0,11990401,11990401,0.0,0
Back to the Future,19000000,381109762,362109762,19.05840852631579,1
Psycho,806948,32000000,31193052,38.655591190510414,1
Casablanca,878000,10462500,9584500,10.916287015945333,1
Modern Times,1,8500000,8499999,8499999.0,1
City Lights,1500000,19181,-1480819,-0.9872126666666666,0
Coco,0,0,0,0.0,0
Django Unchained,100000000,425368238,325368238,3.25368238,1
The Dark Knight Rises,250000000,1084939099,834939099,3.339756396,1
3 Idiots,9000000,70000000,61000000,6.777777777777778,1
Taare Zameen Par,2600000,28430000,25830000,9.934615384615384,1
WALL�E,180000000,521311860,341311860,1.896177,1
Memento,9000000,39723096,30723096,3.413677333333333,1
Once Upon a Time in America,30000000,0,-30000000,-1.0,0
Raiders of the Lost Ark,18000000,389925971,371925971,20.662553944444443,1
The Shining,19000000,44017374,25017374,1.316703894736842,0
Apocalypse Now,31500000,89460381,57960381,1.8400120952380952,1
Alien,11000000,104931801,93931801,8.539254636363637,1
Dr. Strangelove or: How I Learned to Stop Worrying and Love the Bomb,1800000,9440272,7640272,4.244595555555556,1
Witness for the Prosecution,3000000,9000000,6000000,2.0,1
Paths of Glory,935000,0,-935000,-1.0,0
Rear Window,1000000,36764313,35764313,35.764313,1
The Great Dictator,2000000,11000000,9000000,4.5,1
Drishyam,0,0,0,0.0,0
Jagten,3800000,16800000,13000000,3.421052631578948,1
Incendies,6800000,7103838,303838,0.0446820588235294,0
Inglourious Basterds,70000000,319131050,249131050,3.559015,1
Eternal Sunshine of the Spotless Mind,20000000,72258126,52258126,2.6129063,1
Snatch,10000000,83557872,73557872,7.3557872,1
Requiem for a Dream,4500000,7390108,2890108,0.6422462222222223,0
American Beauty,15000000,356296601,341296601,22.753106733333333,1
Good Will Hunting,10000000,225933435,215933435,21.5933435,1
Toy Story,30000000,373554033,343554033,11.4518011,1
Braveheart,72000000,210000000,138000000,1.9166666666666667,1
Reservoir Dogs,1200000,14661007,13461007,11.217505833333334,1
Full Metal Jacket,17000000,46357676,29357676,1.7269221176470588,1
Aliens,18500000,183316455,164816455,8.908997567567567,1
Amadeus,18000000,51973029,33973029,1.8873905,1
Scarface,25000000,65884703,40884703,1.63538812,1
Das Boot,14000000,85000000,71000000,5.071428571428571,1
Taxi Driver,1300000,28262574,26962574,20.74044153846154,1
The Sting,5500000,159616327,154116327,28.02115036363636,1
A Clockwork Orange,2200000,26589000,24389000,11.085909090909093,1
2001: A Space Odyssey,10500000,68700000,58200000,5.542857142857143,1
Per qualche dollaro in pi�,600000,15000000,14400000,24.0,1
Lawrence of Arabia,15000000,69995385,54995385,3.666359,1
The Apartment,3000000,25000000,22000000,7.333333333333333,1
North by Northwest,4000000,13275000,9275000,2.31875,1
Vertigo,2479000,28000000,25521000,10.294876966518755,1
Singin' in the Rain,2540800,7200000,4659200,1.8337531486146093,1
Ladri di biciclette,133000,361712,228712,1.719639097744361,1
Double Indemnity,927262,2500000,1572738,1.696109621660329,1
Citizen Kane,839727,23217674,22377947,26.64907404430249,1
Metropolis,92620000,650422,-91969578,-0.992977521053768,0
The Kid,250000,2500000,2250000,9.0,1
Talvar,0,0,0,0.0,0
Baahubali 2: The Conclusion,18000000,230000000,212000000,11.77777777777778,1
Queen,0,0,0,0.0,0
Mandariinid,0,0,0,0.0,0
Bhaag Milkha Bhaag,4600000,25000000,20400000,4.434782608695652,1
Udaan,0,0,0,0.0,0
Paan Singh Tomar,0,0,0,0.0,0
El secreto de sus ojos,2000000,33965843,31965843,15.9829215,1
Warrior,25000000,23057115,-1942885,-0.0777154,0
Shutter Island,80000000,294804195,214804195,2.6850524375,1
Up,175000000,735099082,560099082,3.200566182857143,1
The Wolf of Wall Street,100000000,392000694,292000694,2.92000694,1
Chak De! India,0,19300000,19300000,0.0,0
There Will Be Blood,25000000,77208711,52208711,2.08834844,1
Toy Story 3,200000000,1066969703,866969703,4.334848515,1
V for Vendetta,54000000,132511035,78511035,1.4539080555555557,0
Rang De Basanti,2200000,11502151,9302151,4.228250454545455,1
Black,0,733094,733094,0.0,0
Batman Begins,150000000,374218673,224218673,1.4947911533333331,0
Der Untergang,18339750,92180910,73841160,4.026290434711488,1
A Beautiful Mind,60000000,313542341,253542341,4.2257056833333335,1
Hera Pheri,0,0,0,0.0,0
"Lock, Stock and Two Smoking Barrels",1350000,3897569,2547569,1.887088148148148,1
L.A. Confidential,35000000,126216940,91216940,2.6061982857142856,1
Heat,60000000,187436818,127436818,2.123946966666667,1
Casino,52000000,116112375,64112375,1.2329302884615383,0
Andaz Apna Apna,0,0,0,0.0,0
Unforgiven,14000000,159157447,145157447,10.368389071428572,1
Indiana Jones and the Last Crusade,48000000,474171806,426171806,8.878579291666666,1
Die Hard,28000000,140767956,112767956,4.027427,1
Raging Bull,18000000,23000000,5000000,0.2777777777777778,0
Stalker,0,0,0,0.0,0
H�stsonaten,0,0,0,0.0,0
The Message,0,0,0,0.0,0
Monty Python and the Holy Grail,400000,5028948,4628948,11.57237,1
The Great Escape,4000000,11744471,7744471,1.93611775,1
To Kill a Mockingbird,2000000,13129846,11129846,5.564923,1
Judgment at Nuremberg,3000000,10000000,7000000,2.333333333333333,1
Some Like It Hot,2883848,25000000,22116152,7.668972844615943,1
Smultronst�llet,0,0,0,0.0,0
Det sjunde inseglet,0,0,0,0.0,0
Du rififi chez les hommes,0,460226,460226,0.0,0
Dial M for Murder,1400000,3000000,1600000,1.1428571428571428,0
All About Eve,1400000,63463,-1336537,-0.9546692857142856,0
The Treasure of the Sierra Madre,3800000,4307000,507000,0.1334210526315789,0
To Be or Not to Be,0,0,0,0.0,0
The Gold Rush,923000,2500000,1577000,1.7085590465872156,1
Pink,75000000,0,-75000000,-1.0,0
Contratiempo,4000000,0,-4000000,-1.0,0
Mommy,4900000,3494070,-1405930,-0.2869244897959184,0
Haider,0,0,0,0.0,0
Logan,135000,10474,-124526,-0.9224148148148148,0
Room,6000000,35401758,29401758,4.900293,1
Relatos salvajes,0,27007072,27007072,0.0,0
PK,13000000,120000000,107000000,8.23076923076923,1
OMG: Oh My God!,0,0,0,0.0,0
The Grand Budapest Hotel,30000000,174600318,144600318,4.8200106,1
Gone Girl,61000000,369330363,308330363,5.054596114754099,1
Hacksaw Ridge,40000000,175302354,135302354,3.38255885,1
Inside Out,0,0,0,0.0,0
Barfi!,4437508,2804874,-1632634,-0.3679168578400309,0
12 Years a Slave,20000000,187000000,167000000,8.35,1
Rush,0,0,0,0.0,0
Spotlight,20000000,88346473,68346473,3.41732365,1
Song of the Sea,0,857522,857522,0.0,0
Kahaani,1200000,16000000,14800000,12.333333333333334,1
Zindagi Na Milegi Dobara,0,0,0,0.0,0
Prisoners,46000000,122126687,76126687,1.6549279782608697,1
Mad Max: Fury Road,150000000,378858340,228858340,1.5257222666666668,1
Gran Torino,33000000,269958228,236958228,7.180552363636363,1
Harry Potter and the Deathly Hallows: Part 2,125000000,1342000000,1217000000,9.736,1
Hachi: A Dog's Tale,16000000,47801389,31801389,1.9875868125,1
Mary and Max,590235,1725381,1135146,1.9232102467661183,1
How to Train Your Dragon,165000000,494878759,329878759,1.999265206060606,1
Into the Wild,15000000,56255142,41255142,2.7503428,1
No Country for Old Men,25000000,171600000,146600000,5.864,1
Lage Raho Munna Bhai,0,0,0,0.0,0
Million Dollar Baby,30000000,216763646,186763646,6.2254548666666665,1
Hotel Rwanda,17500000,38000000,20500000,1.1714285714285717,0
Before Sunset,2700000,15992615,13292615,4.923190740740741,1
Munna Bhai M.B.B.S.,0,0,0,0.0,0
Dil Chahta Hai,2079000,4099000,2020000,0.9716209716209716,0
Kill Bill: Vol. 1,30000000,180949000,150949000,5.031633333333334,1
Finding Nemo,94000000,940335536,846335536,9.003569531914893,1
Catch Me If You Can,52000000,352114312,300114312,5.771429076923077,1
Amores perros,2000000,20908467,18908467,9.4542335,1
"Monsters, Inc.",115000000,562816256,447816256,3.8940544,1
The Sixth Sense,40000000,672806292,632806292,15.8201573,1
La leggenda del pianista sull'oceano,9000000,0,-9000000,-1.0,0
The Truman Show,60000000,264118201,204118201,3.4019700166666667,1
The Big Lebowski,15000000,46189568,31189568,2.079304533333333,1
Trainspotting,4000000,16491080,12491080,3.12277,1
Fargo,7000000,60611975,53611975,7.658853571428572,1
Underground,0,0,0,0.0,0
Dilwale Dulhania Le Jayenge,13200000,100000000,86800000,6.575757575757576,1
Before Sunrise,2500000,5535405,3035405,1.214162,0
Jurassic Park,63000000,920100000,857100000,13.604761904761904,1
In the Name of the Father,13000000,65796862,52796862,4.0612970769230765,1
Dead Poets Society,16400000,235860116,219460116,13.381714390243902,1
Stand by Me,8000000,52287414,44287414,5.53592675,1
Platoon,6000000,138530565,132530565,22.0884275,1
"Paris, Texas",1746964,2181987,435023,0.2490165796204157,0
The Thing,15000000,19629760,4629760,0.3086506666666667,0
Pink Floyd: The Wall,12000000,22244207,10244207,0.8536839166666667,0
Fitzcarraldo,7362000,0,-7362000,-1.0,0
Fanny och Alexander,0,4971340,4971340,0.0,0
Blade Runner,28000000,33139618,5139618,0.1835577857142857,0
The Elephant Man,5000000,26010864,21010864,4.2021728,1
Life of Brian,4000000,20045115,16045115,4.01127875,1
The Deer Hunter,15000000,50000000,35000000,2.333333333333333,1
Rocky,1000000,117235147,116235147,116.235147,1
Network,3800000,23689877,19889877,5.234178157894737,1
Barry Lyndon,11000000,20000000,9000000,0.8181818181818182,0
Chinatown,6000000,30000000,24000000,4.0,1
Paper Moon,0,0,0,0.0,0
Viskningar och rop,0,0,0,0.0,0
Solaris,47000000,30002758,-16997242,-0.3616434468085106,0
Cool Hand Luke,3000000,16217773,13217773,4.405924333333333,1
Persona,0,0,0,0.0,0
La battaglia di Algeri,800000,921548,121548,0.151935,0
El �ngel exterminador,0,0,0,0.0,0
What Ever Happened to Baby Jane?,980000,0,-980000,-1.0,0
The Man Who Shot Liberty Valance,3200000,8000000,4800000,1.5,0
Jungfruk�llan,0,0,0,0.0,0
Inherit the Wind,0,0,0,0.0,0
Ben-Hur,15000000,146900000,131900000,8.793333333333333,1
Le notti di Cabiria,0,752045,752045,0.0,0
The Bridge on the River Kwai,3000000,27200000,24200000,8.066666666666666,1
On the Waterfront,910000,9600000,8690000,9.54945054945055,1
Le salaire de la peur,0,0,0,0.0,0
Ace in the Hole,1821052,1300000,-521052,-0.2861269200440185,0
White Heat,0,0,0,0.0,0
The Third Man,0,596349,596349,0.0,0
The Red Shoes,500000,0,-500000,-1.0,0
The Shop Around the Corner,0,0,0,0.0,0
Rebecca,1288000,6000000,4712000,3.658385093167702,1
Mr. Smith Goes to Washington,1500000,9600000,8100000,5.4,1
Gone with the Wind,4000000,400176459,396176459,99.04411475,1
La Grande Illusion,0,0,0,0.0,0
It Happened One Night,325000,4500000,4175000,12.846153846153848,1
La passion de Jeanne d'Arc,0,0,0,0.0,0
The Circus,9000000,0,-9000000,-1.0,0
Sunrise: A Song of Two Humans,0,121,121,0.0,0
The General,0,1214198,1214198,0.0,0
Das Cabinet des Dr. Caligari,18000,0,-18000,-1.0,0
Airlift,4500000,32000000,27500000,6.111111111111111,1
Bajrangi Bhaijaan,14000000,98000000,84000000,6.0,1
Baby,0,0,0,0.0,0
La La Land,30000000,445435700,415435700,13.847856666666669,1
Lion,12000000,140302754,128302754,10.691896166666666,1
The Martian,108000000,630161890,522161890,4.834832314814815,1
Zootopia,150000000,1023784195,873784195,5.825227966666667,1
Short Term 12,0,1600000,1600000,0.0,0
The Imitation Game,14000000,233555708,219555708,15.682550571428571,1
Guardians of the Galaxy,170000000,773328629,603328629,3.5489919352941177,1
Her,23000000,47351251,24351251,1.0587500434782608,0
The Revenant,0,0,0,0.0,0
The Perks of Being a Wallflower,13000000,33400000,20400000,1.5692307692307692,1
The King's Speech,15000000,414211549,399211549,26.614103266666667,1
The Help,25000000,124272124,99272124,3.97088496,1
Deadpool,58000000,783112979,725112979,12.501947913793105,1
Dev.D,0,0,0,0.0,0
My Name Is Khan,12000000,42345360,30345360,2.52878,1
Slumdog Millionaire,15000000,377910544,362910544,24.194036266666668,1
Black Swan,13000000,327803731,314803731,24.21567161538461,1
Tropa de Elite,4000000,0,-4000000,-1.0,0
The Avengers,60000000,48585416,-11414584,-0.1902430666666666,0
Persepolis,7300000,0,-7300000,-1.0,0
Dallas Buyers Club,5000000,55198285,50198285,10.039657,1
The Pursuit of Happyness,55000000,307077295,252077295,4.583223545454546,1
Blood Diamond,100000000,170877916,70877916,0.70877916,0
The Bourne Ultimatum,70000000,442824138,372824138,5.326059114285714,1
Sin City,40000000,158733820,118733820,2.9683455,1
Le scaphandre et le papillon,14000000,19777647,5777647,0.4126890714285714,0
G.O.R.A.,0,0,0,0.0,0
Ratatouille,150000000,623722818,473722818,3.15815212,1
Casino Royale,12000000,41744718,29744718,2.4787265,1
Kill Bill: Vol. 2,30000000,152159461,122159461,4.071982033333334,1
Mar adentro,12806000,38535221,25729221,2.0091535998750585,1
Cinderella Man,88000000,108539911,20539911,0.2334080795454545,0
Pirates of the Caribbean: The Curse of the Black Pearl,140000000,655011224,515011224,3.6786516,1
Big Fish,70000000,122919055,52919055,0.7559865,0
The Incredibles,92000000,631442092,539442092,5.863501,1
Dogville,10000000,16680836,6680836,0.6680836,0
Vizontele,0,0,0,0.0,0
Donnie Darko,6000000,1270522,-4729478,-0.7882463333333334,0
Magnolia,37000000,48451803,11451803,0.3095081891891892,0
Dancer in the Dark,12800000,40031879,27231879,2.127490546875,1
The Straight Story,10000000,0,-10000000,-1.0,0
Festen,1300000,0,-1300000,-1.0,0
Central do Brasil,2900000,5596708,2696708,0.9298993103448276,0
The Iron Giant,70000000,23159305,-46840695,-0.6691527857142857,0
Knockin' on Heaven's Door,0,0,0,0.0,0
Sling Blade,1000000,24444121,23444121,23.444121,1
Secrets & Lies,4500000,13417292,8917292,1.9816204444444443,1
Twelve Monkeys,29500000,168840000,139340000,4.7233898305084745,1
K�kaku Kid�tai,0,101203,101203,0.0,0
The Nightmare Before Christmas,18000000,75634409,57634409,3.201911611111111,1
Groundhog Day,14600000,70906973,56306973,3.8566419863013697,1
Bound by Honor,35000000,0,-35000000,-1.0,0
Scent of a Woman,31000000,134095253,103095253,3.3256533225806453,1
Aladdin,28000000,504050219,476050219,17.001793535714285,1
JFK,40000000,205405498,165405498,4.13513745,1
Beauty and the Beast,25000000,377350553,352350553,14.09402212,1
Dances with Wolves,22000000,424208848,402208848,18.28222036363636,1
Do the Right Thing,6500000,37295445,30795445,4.7377607692307695,1
Rain Man,25000000,412800000,387800000,15.512,1
The Princess Bride,16000000,30857814,14857814,0.928613375,0
Der Himmel �ber Berlin,2500000,3200000,700000,0.28,0
The Terminator,6400000,78371200,71971200,11.2455,1
Gandhi,22000000,77737889,55737889,2.533540409090909,1
Being There,0,30177511,30177511,0.0,0
Annie Hall,4000000,38251425,34251425,8.56285625,1
Jaws,7000000,470654000,463654000,66.23628571428571,1
Dog Day Afternoon,1800000,46665856,44865856,24.925475555555558,1
Young Frankenstein,2800000,86273333,83473333,29.811904642857144,1
Papillon,12000000,53267000,41267000,3.4389166666666666,1
The Exorcist,8000000,441306145,433306145,54.163268125,1
Sleuth,0,0,0,0.0,0
The Last Picture Show,1300000,29133000,27833000,21.41,1
Fiddler on the Roof,9000000,83304330,74304330,8.256036666666667,1
Il conformista,750000,0,-750000,-1.0,0
Butch Cassidy and the Sundance Kid,6000000,102308889,96308889,16.0514815,1
Rosemary's Baby,3200000,33395426,30195426,9.436070625,1
Planet of the Apes,5800000,33395426,27595426,4.757832068965517,1
The Graduate,3000000,104945305,101945305,33.981768333333335,1
Who's Afraid of Virginia Woolf?,7500000,33736689,26236689,3.4982252,1
The Sound of Music,8200000,286214286,278014286,33.9041812195122,1
Doctor Zhivago,11000000,111858363,100858363,9.168942090909091,1
Per un pugno di dollari,200000,14500000,14300000,71.5,1
8�,0,0,0,0.0,0
The Hustler,2000000,7600000,5600000,2.8,1
La dolce vita,0,19516000,19516000,0.0,0
Rio Bravo,0,5800000,5800000,0.0,0
Anatomy of a Murder,0,0,0,0.0,0
Touch of Evil,829000,2247465,1418465,1.71105548854041,1
Cat on a Hot Tin Roof,3000000,17570324,14570324,4.8567746666666665,1
Sweet Smell of Success,0,0,0,0.0,0
The Killing,320000,0,-320000,-1.0,0
The Night of the Hunter,795000,0,-795000,-1.0,0
Les diaboliques,0,0,0,0.0,0
Stalag 17,1661530,0,-1661530,-1.0,0
Roman Holiday,1500000,12000000,10500000,7.0,1
A Streetcar Named Desire,1800000,8000000,6200000,3.4444444444444446,1
In a Lonely Place,0,0,0,0.0,0
Kind Hearts and Coronets,0,0,0,0.0,0
Rope,1500000,2200000,700000,0.4666666666666667,0
Out of the Past,0,0,0,0.0,0
Brief Encounter,0,0,0,0.0,0
Laura,1020000,2000000,980000,0.9607843137254902,0
The Best Years of Our Lives,2100000,23650000,21550000,10.261904761904765,1
Arsenic and Old Lace,1120175,0,-1120175,-1.0,0
The Maltese Falcon,375000,1000000,625000,1.6666666666666667,1
The Grapes of Wrath,750000,0,-750000,-1.0,0
The Wizard of Oz,2777000,33754967,30977967,11.15519157364062,1
The Thin Man,226408,1423000,1196592,5.285113600226141,1
All Quiet on the Western Front,1250000,0,-1250000,-1.0,0
Call Me by Your Name,4696772,0,-4696772,-1.0,0
"I, Daniel Blake",0,260354,260354,0.0,0
Hunt for the Wilderpeople,0,0,0,0.0,0
Captain Fantastic,5000000,5879736,879736,0.1759472,0
Sing Street,4000000,13624522,9624522,2.4061305,1
Thor: Ragnarok,0,0,0,0.0,0
Nightcrawler,8500000,38697217,30197217,3.552613764705882,1
Arrival,47000000,203388186,156388186,3.327408212765957,1
Before Midnight,3000000,11176469,8176469,2.725489666666667,1
X-Men: Days of Future Past,250000000,747862775,497862775,1.9914511,1
The Artist,15000000,133432856,118432856,7.895523733333333,1
Edge of Tomorrow,178000000,370541256,192541256,1.0816924494382023,0
Amour,8900000,29844753,20944753,2.353343033707865,1
Un proph�te,13000000,0,-13000000,-1.0,0
Moon,5000000,9760104,4760104,0.9520208,0
L�t den r�tte komma in,4000000,10785801,6785801,1.69645025,1
District 9,30000000,210819611,180819611,6.027320366666666,1
The Wrestler,6000000,44703995,38703995,6.450665833333334,1
Jab We Met,2300000,4600000,2300000,1.0,0
Boyhood,4000000,44349000,40349000,10.08725,1
Star Trek,150000000,385680446,235680446,1.5712029733333333,1
In Bruges,15000000,34533783,19533783,1.3022522,0
The Man from Earth,0,0,0,0.0,0
Letters from Iwo Jima,19000000,68673228,49673228,2.614380421052632,1
The Fall,0,3669465,3669465,0.0,0
Life of Pi,120000000,609016565,489016565,4.0751380416666665,1
Fantastic Mr. Fox,40000000,46471023,6471023,0.161775575,0
Iron Man,140000000,585174222,445174222,3.179815871428572,1
Shaun of the Dead,4000000,30039392,26039392,6.509848,1
Gegen die Wand,0,11030861,11030861,0.0,0
Mystic River,25000000,156822020,131822020,5.2728808,1
Harry Potter and the Prisoner of Azkaban,130000000,789804554,659804554,5.075419646153846,1
Hable con ella,9285469,51001550,41716081,4.49261970504667,1
No Man's Land,0,0,0,0.0,0
The Bourne Identity,60000000,214034224,154034224,2.567237066666667,1
Children of Men,76000000,69959751,-6040249,-0.0794769605263158,0
Almost Famous,60000000,47383689,-12616311,-0.21027185,0
Mulholland Dr.,0,0,0,0.0,0
Toy Story 2,90000000,497366869,407366869,4.526298544444445,1
Boogie Nights,15000000,43101594,28101594,1.8734396,1
Once Were Warriors,0,2201126,2201126,0.0,0
True Romance,12500000,12281551,-218449,-0.01747592,0
Carlito's Way,30000000,36516012,6516012,0.2172004,0
Edward Scissorhands,20000000,53000000,33000000,1.65,1
My Left Foot: The Story of Christy Brown,645180,14743391,14098211,21.85159335379274,1
Crimes and Misdemeanors,19000000,18254702,-745298,-0.0392262105263157,0
The Untouchables,25000000,76270454,51270454,2.05081816,1
Hannah and Her Sisters,6400000,40084041,33684041,5.26313140625,1
Brazil,15000000,0,-15000000,-1.0,0
This Is Spinal Tap,2500000,4736202,2236202,0.8944808,0
A Christmas Story,0,19294144,19294144,0.0,0
The Blues Brothers,27000000,115229890,88229890,3.267773703703704,1
Manhattan,0,39946780,39946780,0.0,0
All That Jazz,0,37823676,37823676,0.0,0
Dawn of the Dead,28000000,102356381,74356381,2.6555850357142856,1
All the President's Men,8500000,70600000,62100000,7.305882352941176,1
Amarcord,0,0,0,0.0,0
"Aguirre, der Zorn Gottes",92000,0,-92000,-1.0,0
Harold and Maude,1200000,0,-1200000,-1.0,0
Patton,12000000,89800000,77800000,6.483333333333333,1
The Wild Bunch,6244087,638641,-5605446,-0.8977206755767496,0
Night of the Living Dead,114000,30000000,29886000,262.1578947368421,1
The Lion in Winter,0,0,0,0.0,0
In the Heat of the Night,2000000,27379978,25379978,12.689989,1
Charade,4000000,13474588,9474588,2.368647,1
The Manchurian Candidate,80000000,96105910,16105910,0.201323875,0
Spartacus,12000000,60000000,48000000,4.0,1
L'avventura,0,0,0,0.0,0
Hiroshima mon amour,0,0,0,0.0,0
The Ten Commandments,13000000,122700000,109700000,8.438461538461539,1
The Searchers,3750000,0,-3750000,-1.0,0
East of Eden,1,5,4,4.0,1
High Noon,730000,8000000,7270000,9.95890410958904,1
Strangers on a Train,1200000,7000000,5800000,4.833333333333333,1
Harvey,0,0,0,0.0,0
Miracle on 34th Street,0,46264384,46264384,0.0,0
Notorious,2000000,24464742,22464742,11.232371,1
The Big Sleep,0,0,0,0.0,0
The Lost Weekend,1250000,11000000,9750000,7.8,1
The Philadelphia Story,0,0,0,0.0,0
His Girl Friday,0,0,0,0.0,0
The Adventures of Robin Hood,2033000,3981000,1948000,0.9581898671913428,0
A Night at the Opera,0,0,0,0.0,0
King Kong,672000,10000000,9328000,13.88095238095238,1
Freaks,0,0,0,0.0,0
Dunkirk,0,0,0,0.0,0
Perfetti sconosciuti,0,0,0,0.0,0
Hidden Figures,25000000,230698791,205698791,8.22795164,1
Kubo and the Two Strings,60000000,69929545,9929545,0.1654924166666666,0
Manchester by the Sea,9000000,75026965,66026965,7.336329444444444,1
Under sandet,5070773,0,-5070773,-1.0,0
Captain America: Civil War,250000000,1153304495,903304495,3.61321798,1
The Hateful Eight,44000000,155760117,111760117,2.5400026590909093,1
Little Women,18000000,0,-18000000,-1.0,0
Pride,0,0,0,0.0,0
Le pass�,11000000,10631747,-368253,-0.0334775454545454,0
La grande bellezza,12400000,8371085,-4028915,-0.3249125,0
Vicky Donor,0,0,0,0.0,0
Big Hero 6,165000000,652105443,487105443,2.9521542,1
About Time,12000000,87100449,75100449,6.25837075,1
English Vinglish,2840000,11620000,8780000,3.091549295774648,1
La migliore offerta,13500000,19255873,5755873,0.4263609629629629,0
Moonrise Kingdom,16000000,68263166,52263166,3.266447875,1
How to Train Your Dragon 2,145000000,609123048,464123048,3.200848606896552,1
The Big Short,28000000,133346506,105346506,3.762375214285714,1
The Girl with the Dragon Tattoo,90000000,232617430,142617430,1.5846381111111112,1
Captain Phillips,55000000,95000000,40000000,0.7272727272727273,0
Straight Outta Compton,28000000,201634991,173634991,6.201249678571428,1
The Hobbit: The Desolation of Smaug,250000000,958400000,708400000,2.8336,1
M�n som hatar kvinnor,13000000,104345682,91345682,7.026590923076923,1
The Fighter,25000000,93617009,68617009,2.74468036,1
Taken,25000000,226830568,201830568,8.07322272,1
The Boy in the Striped Pyjamas,12500000,20416563,7916563,0.63332504,0
Once,160000,20710513,20550513,128.44070625,1
The Hobbit: An Unexpected Journey,250000000,1021103568,771103568,3.084414272,1
Auf der anderen Seite,3800000,17804565,14004565,3.685411842105263,1
Atonement,30000000,129266061,99266061,3.3088687,1
Drive,15000000,78054825,63054825,4.203655,1
American Gangster,100000000,266465037,166465037,1.66465037,1
Avatar,237000000,2787965087,2550965087,10.763565767932487,1
Mr. Nobody,47000000,3547209,-43452791,-0.9245274680851064,0
Apocalypto,40000000,120175290,80175290,2.00438225,1
Little Miss Sunshine,8000000,100523181,92523181,11.565397625,1
Hot Fuzz,12000000,80573774,68573774,5.714481166666666,1
The Curious Case of Benjamin Button,150000000,333932083,183932083,1.2262138866666668,0
Veer-Zaara,7000000,29385320,22385320,3.197902857142857,1
Adams �bler,3700000,0,-3700000,-1.0,0
Pride & Prejudice,28000000,121147947,93147947,3.326712392857143,1
The World's Fastest Indian,25000000,0,-25000000,-1.0,0
Serenity,39000000,38869464,-130536,-0.0033470769230769,0
Walk the Line,28000000,186438883,158438883,5.658531535714285,1
Ondskan,0,0,0,0.0,0
The Notebook,29000000,115603229,86603229,2.98631824137931,1
Diarios de motocicleta,0,16756372,16756372,0.0,0
Les triplettes de Belleville,8000000,1477676,-6522324,-0.8152905,0
The Count of Monte Cristo,35000000,75395048,40395048,1.1541442285714285,0
Waking Life,0,3176880,3176880,0.0,0
Remember the Titans,30000000,136706683,106706683,3.556889433333333,1
Todo sobre mi madre,8272296,67872296,59600000,7.204771202577858,1
Cast Away,90000000,429632142,339632142,3.773690466666667,1
The Boondock Saints,6000000,30471,-5969529,-0.9949215,0
The Insider,90000000,60289912,-29710088,-0.3301120888888889,0
October Sky,0,0,0,0.0,0
Shrek,60000000,484409218,424409218,7.073486966666667,1
Titanic,200000000,1845034188,1645034188,8.22517094,1
Gattaca,36000000,12532777,-23467223,-0.6518673055555556,0
The Game,50000000,109423648,59423648,1.18847296,0
Breaking the Waves,0,3803298,3803298,0.0,0
Ed Wood,18000000,5887457,-12112543,-0.6729190555555555,0
What's Eating Gilbert Grape,11000000,10032765,-967235,-0.0879304545454545,0
Tombstone,25000000,56505065,31505065,1.2602026,0
The Sandlot,0,32416586,32416586,0.0,0
The Remains of the Day,11500000,23237911,11737911,1.0206879130434785,0
Naked,0,0,0,0.0,0
The Fugitive,44000000,368875760,324875760,7.38354,1
A Bronx Tale,22000000,17287898,-4712102,-0.2141864545454545,0
Batman: Mask of the Phantasm,6000000,5617391,-382609,-0.0637681666666666,0
Night on Earth,3500000,2015810,-1484190,-0.4240542857142857,0
La double vie de V�ronique,0,1999955,1999955,0.0,0
Boyz n the Hood,6500000,57504069,51004069,7.846779846153846,1
Misery,20000000,61276872,41276872,2.0638436,1
Awakenings,0,52096475,52096475,0.0,0
Glory,18000000,26828365,8828365,0.4904647222222222,0
Back to the Future Part II,40000000,332000000,292000000,7.3,1
Mississippi Burning,15000000,34604000,19604000,1.3069333333333333,0
Predator,18000000,98235548,80235548,4.457530444444444,1
Evil Dead II,3600000,5923044,2323044,0.64529,0
Ferris Bueller's Day Off,6000000,70136369,64136369,10.689394833333331,1
Down by Law,0,0,0,0.0,0
The Goonies,19000000,61503218,42503218,2.2370114736842104,1
The Color Purple,15000000,146292009,131292009,8.7528006,1
The Breakfast Club,1000000,51525171,50525171,50.525171,1
The Killing Fields,14400000,34700291,20300291,1.4097424305555557,0
Ghostbusters,30000000,295212467,265212467,8.840415566666668,1
The Right Stuff,27000000,21500000,-5500000,-0.2037037037037037,0
The King of Comedy,20000000,0,-20000000,-1.0,0
E.T. the Extra-Terrestrial,10500000,792965326,782465326,74.52050723809523,1
Kramer vs. Kramer,8000000,106260000,98260000,12.2825,1
Days of Heaven,0,0,0,0.0,0
The Outlaw Josey Wales,3700000,31800000,28100000,7.594594594594595,1
The Man Who Would Be King,0,0,0,0.0,0
The Conversation,1600000,4420000,2820000,1.7625,1
La plan�te sauvage,0,0,0,0.0,0
The Day of the Jackal,0,0,0,0.0,0
Badlands,0,0,0,0.0,0
Cabaret,6000000,0,-6000000,-1.0,0
Willy Wonka & the Chocolate Factory,3000000,4000000,1000000,0.3333333333333333,0
Midnight Cowboy,3600000,44785053,41185053,11.4402925,1
Wait Until Dark,4000000,11000000,7000000,1.75,1
Guess Who's Coming to Dinner,4000000,56666667,52666667,13.16666675,1
Bonnie and Clyde,2500000,50700000,48200000,19.28,1
My Fair Lady,17000000,72070731,55070731,3.2394547647058825,1
Mary Poppins,6000000,102272727,96272727,16.0454545,1
The Longest Day,10000000,50100000,40100000,4.01,1
Jules et Jim,0,0,0,0.0,0
The Innocents,0,0,0,0.0,0
� bout de souffle,0,0,0,0.0,0
Red River,3000000,9012000,6012000,2.004,1
Key Largo,0,0,0,0.0,0
To Have and Have Not,0,3650000,3650000,0.0,0
Shadow of a Doubt,0,0,0,0.0,0
Stagecoach,531374,1103757,572383,1.077175398118839,0
The Lady Vanishes,0,0,0,0.0,0
Bringing Up Baby,1073000,0,-1073000,-1.0,0
Bride of Frankenstein,393750,0,-393750,-1.0,0
Duck Soup,0,0,0,0.0,0
Frankenstein,45000000,112006296,67006296,1.4890288,0
Roma,0,0,0,0.0,0
God's Own Country,0,0,0,0.0,0
Wind River,11000000,184770205,173770205,15.797291363636363,1
Get Out,5000000,252434250,247434250,49.48685,1
En man som heter Ove,0,3371692,3371692,0.0,0
What We Do in the Shadows,0,3333000,3333000,0.0,0
The Theory of Everything,0,0,0,0.0,0
Kingsman: The Secret Service,81000000,414351546,333351546,4.115451185185186,1
The Fault in Our Stars,12000000,307166834,295166834,24.597236166666665,1
Me and Earl and the Dying Girl,0,0,0,0.0,0
The Broken Circle Breakdown,0,5475058,5475058,0.0,0
Captain America: The Winter Soldier,170000000,714766572,544766572,3.2045092470588235,1
Rockstar,10920000,19660000,8740000,0.8003663003663004,0
Nebraska,12000000,17654912,5654912,0.4712426666666666,0
Wreck-It Ralph,165000000,471222889,306222889,1.855896296969697,1
Detachment,0,72689,72689,0.0,0
Midnight in Paris,30000000,151119219,121119219,4.0373073,1
The Lego Movie,60000000,469160692,409160692,6.8193448666666665,1
Gravity,105000000,716392705,611392705,5.822787666666667,1
Star Trek Into Darkness,190000000,467365246,277365246,1.4598170842105265,0
Beasts of No Nation,6000000,9077700,3077700,0.51295,0
The Social Network,40000000,224920315,184920315,4.623007875,1
The Hangover,35000000,459270619,424270619,12.122017685714283,1
Skyfall,200000000,1108561013,908561013,4.542805065,1
Silver Linings Playbook,21000000,205738714,184738714,8.797081619047619,1
Argo,44500000,232324128,187824128,4.220766921348314,1
(500) Days of Summer,7500000,60722734,53222734,7.096364533333333,1
Harry Potter and the Deathly Hallows: Part 1,250000000,954305868,704305868,2.817223472,1
Frost/Nixon,0,0,0,0.0,0
Changeling,55000000,113020255,58020255,1.0549137272727274,0
Flipped,14000000,1755212,-12244788,-0.8746277142857143,0
This Is England,2380000,8176544,5796544,2.43552268907563,1
Ex Machina,15000000,36869414,21869414,1.4579609333333334,0
Efter brylluppet,0,0,0,0.0,0
The Last King of Scotland,6000000,48027970,42027970,7.004661666666666,1
Zodiac,65000000,84785914,19785914,0.3043986769230769,0
Lucky Number Slevin,27000000,56308881,29308881,1.085514111111111,0
Joyeux No�l,22000000,17709155,-4290845,-0.195038409090909,0
Control,6800000,0,-6800000,-1.0,0
Tangled,260000000,591794936,331794936,1.2761343692307692,0
Zwartboek,21000000,26193068,5193068,0.2472889523809524,0
Brokeback Mountain,14000000,178043761,164043761,11.7174115,1
3:10 to Yuma,0,0,0,0.0,0
Crash,10000000,0,-10000000,-1.0,0
The Bourne Supremacy,75000000,288500217,213500217,2.84666956,1
The Machinist,5000000,8203235,3203235,0.640647,0
Ray,40000000,124731534,84731534,2.11828835,1
Lost in Translation,4000000,119723856,115723856,28.930964,1
Harry Potter and the Goblet of Fire,150000000,895921036,745921036,4.9728069066666665,1
Man on Fire,70000000,130293714,60293714,0.8613387714285714,0
Coraline,60000000,124596398,64596398,1.0766066333333333,0
The Last Samurai,140000000,456758981,316758981,2.26256415,1
The Magdalene Sisters,0,20957001,20957001,0.0,0
In America,0,0,0,0.0,0
I Am Sam,22000000,92542418,70542418,3.206473545454545,1
Adaptation.,19000000,32801173,13801173,0.7263775263157894,0
Black Hawk Down,92000000,172989651,80989651,0.8803222934782609,0
Road to Perdition,80000000,181001478,101001478,1.262518475,0
Das Experiment,0,0,0,0.0,0
Billy Elliot,5000000,110000000,105000000,21.0,1
Hedwig and the Angry Inch,0,0,0,0.0,0
Ocean's Eleven,0,0,0,0.0,0
"O Brother, Where Art Thou?",26000000,71868327,45868327,1.7641664230769232,1
"South Park: Bigger, Longer & Uncut",21000000,0,-21000000,-1.0,0
Office Space,10000000,12827813,2827813,0.2827813,0
Happiness,3000000,2807390,-192610,-0.0642033333333333,0
Training Day,45000000,104876233,59876233,1.3305829555555555,0
Rushmore,9000000,17096053,8096053,0.8995614444444444,0
Abre los ojos,2900000,368234,-2531766,-0.8730227586206897,0
Being John Malkovich,13000000,22863596,9863596,0.7587381538461538,0
As Good as It Gets,50000000,314178011,264178011,5.28356022,1
The Fifth Element,90000000,263920180,173920180,1.9324464444444445,1
Donnie Brasco,35000000,41954997,6954997,0.1987142,0
Shine,0,0,0,0.0,0
Primal Fear,30000000,102616183,72616183,2.420539433333333,1
Hamlet,0,0,0,0.0,0
A Little Princess,17000000,0,-17000000,-1.0,0
Il postino,0,0,0,0.0,0
Clerks,27000,3151130,3124130,115.70851851851852,1
Short Cuts,0,6110979,6110979,0.0,0
Philadelphia,26000000,206678440,180678440,6.949170769230769,1
The Muppet Christmas Carol,0,27281507,27281507,0.0,0
Malcolm X,34000000,48169908,14169908,0.416762,0
The Last of the Mohicans,40000000,75505856,35505856,0.8876464,0
Glengarry Glen Ross,12500000,10725228,-1774772,-0.14198176,0
A Few Good Men,40000000,243240178,203240178,5.08100445,1
Fried Green Tomatoes,11000000,119418501,108418501,9.856227363636364,1
Barton Fink,9000000,6153939,-2846061,-0.316229,0
Miller's Crossing,14000000,5080409,-8919591,-0.6371136428571429,0
Who Framed Roger Rabbit,70000000,329803958,259803958,3.7114851142857135,1
Spoorloos,0,0,0,0.0,0
Withnail & I,0,0,0,0.0,0
The Last Emperor,23000000,43984230,20984230,0.9123578260869564,0
Empire of the Sun,35000000,22238696,-12761304,-0.3646086857142857,0
Blue Velvet,6000000,8551228,2551228,0.4252046666666667,0
The Purple Rose of Cairo,15000000,10631333,-4368667,-0.2912444666666666,0
After Hours,4500000,10609321,6109321,1.357626888888889,0
Zelig,0,11798616,11798616,0.0,0
The Verdict,16000000,53977250,37977250,2.373578125,1
Star Trek II: The Wrath of Khan,12000000,96800000,84800000,7.066666666666666,1
First Blood,15000000,125212904,110212904,7.347526933333333,1
Ordinary People,6000000,0,-6000000,-1.0,0
Airplane!,3500000,83453539,79953539,22.843868285714287,1
Rupan sansei: Kariosutoro no shiro,0,0,0,0.0,0
Halloween,300000,70000000,69700000,232.33333333333331,1
Le locataire,0,0,0,0.0,0
Love and Death,3000000,20173742,17173742,5.724580666666666,1
The Taking of Pelham One Two Three,0,0,0,0.0,0
Blazing Saddles,2600000,119500000,116900000,44.96153846153846,1
Serpico,3000000,29800000,26800000,8.933333333333334,1
Enter the Dragon,850000,90000000,89150000,104.88235294117646,1
Deliverance,2000000,46122355,44122355,22.0611775,1
The French Connection,1800000,41158757,39358757,21.86597611111111,1
Dirty Harry,4000000,35976000,31976000,7.994,1
Where Eagles Dare,7700000,21000000,13300000,1.7272727272727273,1
The Odd Couple,0,44527234,44527234,0.0,0
The Dirty Dozen,5400000,45300000,39900000,7.388888888888889,1
Belle de jour,0,0,0,0.0,0
A Man for All Seasons,3900000,28350000,24450000,6.269230769230769,1
Repulsion,300000,0,-300000,-1.0,0
Zulu,3500000,8000000,4500000,1.2857142857142858,0
Goldfinger,2500000,124881062,122381062,48.9524248,1
The Birds,2500000,11403529,8903529,3.5614116,1
Cape Fear,35000000,182300000,147300000,4.208571428571428,1
Peeping Tom,150000,83957,-66043,-0.4402866666666666,0
The Magnificent Seven,2000000,4905000,2905000,1.4525,0
Invasion of the Body Snatchers,417000,0,-417000,-1.0,0
Rebel Without a Cause,1500000,0,-1500000,-1.0,0
The Ladykillers,0,0,0,0.0,0
Sabrina,58000000,0,-58000000,-1.0,0
The Quiet Man,0,0,0,0.0,0
The Day the Earth Stood Still,1200000,0,-1200000,-1.0,0
The African Queen,1300000,10750000,9450000,7.269230769230769,1
Gilda,0,0,0,0.0,0
Fantasia,2280000,83320000,81040000,35.54385964912281,1
The Invisible Man,328000,0,-328000,-1.0,0
Gifted,7000000,37461045,30461045,4.351577857142857,1
Victoria,0,3191998,3191998,0.0,0
Mustang,1300000,250000,-1050000,-0.8076923076923077,0
Guardians of the Galaxy Vol. 2,200000000,863416141,663416141,3.317080705,1
Baby Driver,34000000,224511319,190511319,5.603274088235295,1
Bridge of Spies,40000000,165478348,125478348,3.1369587,1
Moana,0,0,0,0.0,0
Sicario,30000000,84025816,54025816,1.8008605333333334,1
Creed,37000000,173567581,136567581,3.691015702702703,1
Hell or High Water,12000000,37589296,25589296,2.1324413333333334,1
Philomena,12000000,100129872,88129872,7.344156,1
Dawn of the Planet of the Apes,170000000,710644566,540644566,3.1802621529411765,1
El cuerpo,0,0,0,0.0,0
Serbuan maut,1100000,4105187,3005187,2.7319881818181817,1
End of Watch,7000000,48126384,41126384,5.875197714285714,1
A Star Is Born,0,0,0,0.0,0
True Grit,0,14250000,14250000,0.0,0
H�vnen,15000000,0,-15000000,-1.0,0
Despicable Me,69000000,543513985,474513985,6.877014275362319,1
50/50,8000000,39187783,31187783,3.898472875,1
Kick-Ass,28000000,96188903,68188903,2.4353179642857143,1
Celda 211,5700000,19300483,13600483,2.386049649122807,1
Moneyball,50000000,110206216,60206216,1.20412432,0
La piel que habito,13000000,5774854,-7225146,-0.5557804615384615,0
Zombieland,23600000,102391382,78791382,3.3386178813559324,1
Die Welle,7500000,19000000,11500000,1.5333333333333334,1
Sherlock Holmes,90000000,524028679,434028679,4.822540877777778,1
The Blind Side,29000000,309208309,280208309,9.66235548275862,1
The Visitor,0,9234510,9234510,0.0,0
Seven Pounds,55000000,168167691,113167691,2.057594381818182,1
Eastern Promises,51500000,55112356,3612356,0.0701428349514563,0
Stardust,70000000,135560026,65560026,0.9365718,0
The Secret of Kells,0,0,0,0.0,0
Inside Man,45000000,184376254,139376254,3.097250088888889,1
Gone Baby Gone,19000000,34619699,15619699,0.8220894210526316,0
The Illusionist,40000000,86915017,46915017,1.172875425,0
Dead Man's Shoes,0,0,0,0.0,0
Harry Potter and the Half-Blood Prince,250000000,933959197,683959197,2.735836788,1
300,65000000,422610419,357610419,5.501698753846154,1
Match Point,15000000,85306374,70306374,4.6870916,1
Watchmen,130000000,185258983,55258983,0.4250691,0
Lord of War,42000000,24127895,-17872105,-0.4255263095238095,0
Saw,1200000,103911669,102711669,85.5930575,1
"Synecdoche, New York",21000000,0,-21000000,-1.0,0
Mysterious Skin,0,1524966,1524966,0.0,0
Jeux d'enfants,0,0,0,0.0,0
Un long dimanche de fian�ailles,47000000,0,-47000000,-1.0,0
The Station Agent,500000,8679814,8179814,16.359628,1
21 Grams,20000000,60427839,40427839,2.02139195,1
Finding Neverland,25000000,116766556,91766556,3.67066224,1
25th Hour,15000000,13060843,-1939157,-0.1292771333333333,0
The Butterfly Effect,13000000,96060858,83060858,6.38929676923077,1
The Royal Tenenbaums,21000000,71441250,50441250,2.4019642857142856,1
Y tu mam� tambi�n,5000000,33616692,28616692,5.7233384,1
The Others,0,0,0,0.0,0
Blow,53000000,83282296,30282296,0.5713640754716981,0
Enemy at the Gates,68000000,96976270,28976270,0.4261216176470588,0
Minority Report,102000000,358372926,256372926,2.5134600588235294,1
The Hurricane,50000000,73956241,23956241,0.47912482,0
American Psycho,7000000,34266564,27266564,3.8952234285714287,1
Lola rennt,1530000,7267585,5737585,3.750055555555556,1
The Thin Red Line,52000000,98126565,46126565,0.8870493269230769,0
Mulan,90000000,304320254,214320254,2.381336155555556,1
Fear and Loathing in Las Vegas,18500000,10680275,-7819725,-0.4226878378378378,0
Funny Games,0,0,0,0.0,0
Dark City,27000000,27200316,200316,0.0074191111111111,0
Sleepers,44000000,165615285,121615285,2.76398375,1
Lost Highway,15000000,3675201,-11324799,-0.7549866,0
Sense and Sensibility,16500000,135000000,118500000,7.181818181818182,1
Die Hard: With a Vengeance,90000000,366101666,276101666,3.067796288888889,1
Dead Man,9000000,0,-9000000,-1.0,0
The Bridges of Madison County,24000000,182016617,158016617,6.584025708333333,1
Apollo 13,52000000,355237933,303237933,5.831498711538462,1
Falling Down,25000000,40903593,15903593,0.63614372,0
Dazed and Confused,6900000,7993039,1093039,0.1584114492753623,0
My Cousin Vinny,11000000,64088552,53088552,4.826232,1
Delicatessen,4000000,1794187,-2205813,-0.55145325,0
Home Alone,18000000,476684675,458684675,25.482481944444444,1
The Godfather: Part III,54000000,136766062,82766062,1.5327048518518518,1
When Harry Met Sally...,16000000,92823546,76823546,4.801471625,1
The Little Mermaid,40000000,222300000,182300000,4.5575,1
The Naked Gun: From the Files of Police Squad!,12000000,78756177,66756177,5.56301475,1
Lethal Weapon,15000000,120207127,105207127,7.013808466666666,1
Blood Simple,1500000,0,-1500000,-1.0,0
On Golden Pond,0,19255967,19255967,0.0,0
Mad Max 2,2000000,24600832,22600832,11.300416,1
The Warriors,4000000,22490039,18490039,4.62250975,1
The Muppet Movie,0,76657000,76657000,0.0,0
Escape from Alcatraz,8000000,43000000,35000000,4.375,1
Watership Down,1000000,3713768,2713768,2.713768,1
Midnight Express,2300000,35000000,32700000,14.217391304347826,1
Close Encounters of the Third Kind,20000000,303788635,283788635,14.18943175,1
The Long Goodbye,0,0,0,0.0,0
Gi� la testa,0,0,0,0.0,0
Kelly's Heroes,4000000,5200000,1200000,0.3,0
The Jungle Book,0,0,0,0.0,0
A Hard Day's Night,560000,12299668,11739668,20.963692857142856,1
Breakfast at Tiffany's,2500000,9500000,7000000,2.8,1
Giant,5400000,35000000,29600000,5.481481481481482,1
From Here to Eternity,1650000,30500000,28850000,17.484848484848484,1
Lifeboat,1590000,0,-1590000,-1.0,0
The 39 Steps,0,0,0,0.0,0
